5,6,6,6,6,6,6,6,8
9,2,2,2,2,3,2,2,13
9,2,2,3,3,2,2,2,13
9,3,2,2,2,2,3,2,13
16,2,3,2,2,2,3,2,13
9,2,3,2,3,2,2,2,13
9,2,2,2,2,3,2,3,13
9,2,2,3,2,3,2,2,13
10,11,11,11,11,11,11,11,12
