1,2,2,2,2,2,2,2,4
5,0,0,0,0,0,0,0,9
5,0,0,0,0,0,0,0,9
5,0,0,0,0,0,0,0,9
10,0,0,0,0,0,0,0,9
5,0,0,0,0,0,0,0,9
5,0,0,0,0,0,0,0,9
5,0,0,0,0,0,0,0,9
6,7,7,7,7,7,7,7,8
